################
#X#    @ G    C#
# #         D###
# #          # #
# #          # #
# #       D  # #
# #          # #
# #          # #
# #          # #
# #          # #
# #          # #
# #          # #
# #          # #
# ############ #
#              #
################
